NO ./textures/1.png
SO ./textures/2.png
WE ./textures/3.png
EA ./textures/4.png

F 70,70,80
C 30,30,30

1111111111111111111
1000000000000000001
10000011100000000011111
1000001 00010000001111111
1000001 0W100000001
1000001110000000001
1000000000000000001
1111111111111111111